11
 9 92 37 82 62 101 31 30 48 74 117
84 25 41 65 69 85 111 78 89 113 34
81 100 66 11 42 26 102  7 95  5 53
108 103 120 97 23 99 55 28 91  8 83
112 105 49 73 12 54 115 119 70 76 104
57 90 86  0 68 98 46 50 58 71 116
18 93 87 56 29 59 45 75 15 38 79
80 10 36  4 22 96 77 24 33 51 52
67 72 47 61 35 114 107 110 19  1 14
106 20 88 21  2 39 44 27 40 16 17
13 63 64 43 109 94  3  6 118 60 32