14
128 163 114 172  2 134 31 61 180 28 21 187 64 111
60 136 160 173 153 77 73 137 91 170  8 171 90 51
176 152 104 66 156 12 149 183 125 131 89 39 15 80
59 94 100 143 13 139 25 193 182 140 174 189 50 124
30  7 98 24 146 161 37 19 16 118 138 74 20 47
130  0 105 165 96 132 46 23 112 55 148 151 192 181
75 84 101 185 167 95 97 76 45 194 78  6 11 106
142  1 123 29 184 191 99  5 81 177 33 17 85 67
57 32 83 147 126 53 35 155 109 117 115 159 14 56
65 102 36 141 154 41 43 88 48 122  3 69 145 144
71 54 58 119 34 38 22 42 44 68 82  4 186 166
62 168 10 133 49 52 129 162 175 188 27 103 107 150
92 178 164 79 179 108  9 110 70 26 169 120 63 72
190 113 87 158 93 157 195 127 121 18 40 116 135 86