10
36 31  2 73 13 60 25 94 19 58
79 15 22 80 34 96 28 93  3 64
38 32 75 69 41 98 24  4  1 57
56 84 92 91 27 76 97 53 12 37
30 89 17 86 99 29 59 88 10 42
45 72 85 21  9 95 77 47 70 14
62 33 68 43 54 90 52 35 83 74
66 61 81 18  5 65  7  6 55 16
26 46 78 71 40 20 44 50 63 48
67 87  8  0 11 82 51 23 39 49