15
199 158 201 159 182 101 93 216 84 108 46 81 137  6 13
24 95 22 23 96 83 42 141 172 180 175 160 139 106 89
148 192 140 212 56  2 49 99 43 118 55 58 123 53 65
64 136  3 133 167 166 80 200 187 87 117 183 52  7 79
102 214 74 112 147 188 145 100 162 146 144 143 35 41 132
67 33 116 155  5 194 82 57 134 25 61 171 207 31 211
28 184 130 111 127 94  9 222 185 197 219 191 156 157 60
205 70 152 62  4 34 19 119 193 210 18 121 45 122 48
179 163 204 178 186 109 104 165 161 218 20 126 189 128 16
198 209 202 203 88 131 90 220 47 36 124 120 174 181 29
14 129 12 153 40 10 98 68 50 21 39 17 59 38 73
151 223 86  0 177 135 37 138 30 103 110 75 215 168 217
63 150 195 105 15 176 11 85 72 51  1 27 92 76 71
54 149 107 196 142 32 125 91  8 44 213 173 221 114 164
208 69 224 97 113 170 190 169 26 78 115 206 66 77 154