8
47  2 49  1  5  6  7  8
 4 31  3 50 33 10 34  9
29 51 46 30 32 38 53 11
28 27 62 52 35 43 12 39
48  0 42 60 61 63 54 55
24 26 45 25 19 59 37 36
23 21 44 58 57 40 15 13
22 20 41 56 18 17 14 16